### ######
#        #
# ###### E
# #   ## #
# # # #  #
#   # ####
#####    #
#   #### #
# #      #
# ########
